#;#;#;#;#;#;#;#;#;#;#;#;#;#;#;#;#;#;#;#
#;@; ; ;#;#;#; ; ; ; ; ; ; ; ; ; ; ;?;#
#;#;#; ;#; ; ; ;#;#;#;#;#;#;#;#;#; ;#;#
#; ; ; ;#; ;#; ;#; ; ; ; ; ; ; ; ; ;#;#
#; ;#;#;#; ;#; ;#; ;#;#;#;#; ; ;#;#;#;#
#; ;#; ; ; ;#; ; ; ;#; ; ; ; ;#;#;#;#;#
#; ;#; ;#;#;#;#;#; ;#; ;#;#; ;#;#;#;#;#
#; ;#; ;#;#;#;#;#; ;#; ;#; ; ;#;#;#;#;#
#; ; ; ; ; ; ; ; ; ;#; ;#; ; ;#;#;#;#;#
#; ;#;#;#;#;#;#;#;#;#; ;#;#; ;#;#;#;#;#
#; ; ; ; ; ; ; ; ; ; ; ; ; ; ; ; ; ; ;#
#;#;#;#;#;#;#;#;#;#;#;#;#;#;#;#;#;#;#;#
