#;#;#;#;#;#;#;#;#;#;#;#
#;@; ; ; ; ; ; ;#;#;#;#
#;#;#;#;#;#;#; ;#;#;#;#
#;#;#;#;#;#;#; ; ; ; ;#
#;#;#;#;#;#;#;#;#;#; ;#
#; ; ; ;#;#;#;#;#;#; ;#
#; ;#; ;#; ; ; ; ; ; ;#
#; ;#; ;#; ;#;#;#;#;#;#
#; ;#; ; ; ;#;#;#;#;#;#
#; ;#;#;#;#;#;#;#;#;#;#
#;?;#;#;#;#;#;#;#;#;#;#
#;#;#;#;#;#;#;#;#;#;#;#
