#;#;#;#;#;#;#
#;@; ; ;#;#;#
#;#;#; ;#;#;#
#;#;#; ;#;#;#
#;#;#;?;#;#;#
#;#;#;#;#;#;#
#;#;#;#;#;#;#
